15.ox
.o....oo..
....o..oo.
..oo.o.o..
o.........
....oo.ooo
o.o...oo.o
oo.o..o..o
....o.oo..
.o.o....o.
........o.
...o....oo
.o.o.oo.oo
.o...oo.o.
...o...o..
.ooo.ooooo
